%%%%%%%%%%%%%%%%%%%%%%%%%%%%%%%%%%%%%%%%%%%%%%%%%%%%%%%%%%%%
%%                %%%%%%%%%%%%         %%%%%%%%%%%%%%%%%%%%%
%%                %%%%%%%%%%%%         %%%%%%%%%%%%%%%%%%%%%
%%                2                    %%%%%%%%%%%%%%%%%%%%%
%%                %%%%%%%%%%%%         %%%%%%%%%%%%%%%%%%%%%
%%%%%%%%%%%%%%%%%%%%%%%%%%%%%%%%%%%%33%%%%%%%%%%%%%%%%%%%%%%
%%%%%%%%%%%%%%%%%%%%%%%%%%%%%%%%%%%%  %%%%%%%%%%%%%%%%%%%%%%
%%%%%%%%%%%%%%%%%%%%%%%%%%%%%%%%%%%%  %%%%%%%%%%%%%%%%%%%%%%
%%%%%%%%%%%%%%%%%%%%%%%%%%%%%%%%%%%%  %%%%%%%%%%%%%%%%%%%%%%
%%%%%%%%%                %%%%%%%%%%%  %%%%%%%%%%%%%%%%%%%%%%
%%%%%%%%%        %%%%%%44%%%%%%%%%%%  %%%%%%%%%%%%%%%%%%%%%%
%%%%%%%%%        %%%%%%  %%%%%%%%%%%  %%%%%%%%%%%%%%%%%%%%%%
%%%%%%%%%        %%%%%%  %%%%%%%%%%%  %%%%%%%%%%%%%%%%%%%%%%
%%%%%%%%%%%%%%%%%%%%%%%                %%%%%%%%%%%%%%%%%%%%%
%%%%%%%%%%%%%%%%%%%%%%%                %%%%%%%%%%%%%%%%%%%%%
%%%%%%%%%%%%%%%%%%%%%%%                %%%%%%%%%%%%%%%%%%%%%
%%%%%%%%%%%%%%%%%%%%%%%                %%%%%%%%%%%%%%%%%%%%%
%%%%%%%%%%%%%%%%%%%%%%%                %%%%%%%%%%%%%%%%%%%%%
%%%%%%%%%%%%%%%%%%%%%%%%%%%%%%%%%%%%%%%%%%%%%%%%%%%%%%%%%%%%
%%%%%%%%%%%%%%%%%%%%%%%%%%%%%%%%%%%%%%%%%%%%%%%%%%%%%%%%%%%%
%%%%%%%%%%%%%%%%%%%%%%%%%%%%%%%%%%%%%%%%%%%%%%%%%%%%%%%%%%%%
%%%%%%%%%%%%%%%%%%%%%%%%%%%%%%%%%%%%%%%%%%%%%%%%%%%%%%%%%%%%
END
// maze
#######
#     # 
#     #
#######


game: paper scissor
game: die
game: maze
game: guess number
game: count

box: B/$
see_around: B

location_range: story
dark

save_file



